009,040,050,050,050,050,050,050,050,050,050,151,050,050,050,050,050,050,050,050,050,041,009
009,053,000,000,000,000,999,000,000,000,000,120,000,000,000,000,999,000,000,000,000,051,009
009,053,000,180,121,181,000,130,121,131,000,120,000,130,121,131,000,180,121,181,000,051,009
009,053,000,183,121,182,000,133,121,132,000,112,000,133,121,132,000,183,121,182,000,051,009
009,053,999,000,000,000,999,000,999,000,999,000,999,000,999,000,999,000,000,000,999,051,009
009,053,000,113,121,111,000,110,000,113,121,141,121,111,000,110,000,113,121,111,000,051,009
009,053,000,000,000,000,999,120,000,000,000,122,000,000,000,120,999,000,000,000,000,051,009
009,163,121,121,121,161,000,140,121,111,000,112,000,113,123,142,000,160,121,121,121,162,009
009,009,009,009,009,051,000,120,000,000,999,999,999,000,000,120,000,053,009,009,009,009,009
009,009,009,009,009,051,000,120,000,130,121,998,121,131,000,120,000,053,009,009,009,009,009
009,121,121,121,121,162,000,112,000,122,999,999,999,122,000,112,000,163,121,121,121,121,009
002,003,000,000,000,000,999,000,999,122,999,999,999,122,999,000,999,000,000,000,000,001,004
009,121,121,121,121,161,000,110,000,133,121,121,121,132,000,110,000,160,121,121,121,121,009
009,009,009,009,009,051,000,120,999,000,000,000,000,000,999,120,000,053,009,009,009,009,009
009,160,121,121,121,162,000,112,000,113,121,141,121,111,000,112,000,163,121,121,121,161,009
009,053,000,000,000,000,999,000,999,000,000,122,000,000,999,000,999,000,000,000,000,051,009
009,053,000,113,121,131,000,113,121,111,000,112,000,113,121,111,000,130,121,111,000,051,009
009,053,000,000,000,122,999,000,999,000,999,000,999,000,999,000,999,122,000,000,000,051,009
009,150,121,111,000,112,000,110,000,113,121,141,121,111,000,110,000,112,000,113,121,152,009
009,053,000,000,999,000,000,120,000,000,000,122,000,000,000,120,000,000,999,000,000,051,009
009,053,000,093,052,052,052,153,052,092,000,112,000,093,052,153,052,052,052,092,000,051,009
009,053,000,000,000,000,000,000,000,000,999,000,999,000,000,000,000,000,000,000,000,051,009
009,043,052,052,052,052,052,052,052,052,052,052,052,052,052,052,052,052,052,052,052,042,009,EOM,
11,8;
11,9;11,10;
11,11;11,10;
10,10;10,11;
12,10;12,11;-1,-1;EOH;
//Les coodonnees :
//F0
//Porte,Entrée
//F2(A);F2(B);
//F1(A);F1(B);
//F3(A);F3(B);

//F#(@) : Fantome#(@)
//Trajet initial des fantome (sauf F0) : A <-> B
