40,50,50,50,50,50,50,50,50,71,70,50,50,50,50,50,50,50,41
51,00,00,00,00,00,00,00,00,00,00,00,00,00,00,00,00,00,53
51,00,00,00,00,00,00,00,00,00,00,00,00,00,00,00,00,00,53
51,00,00,00,00,00,00,00,00,00,00,00,00,00,00,00,00,00,53
51,00,00,00,00,00,00,00,00,00,00,00,00,00,00,00,00,00,53
51,00,00,00,00,00,00,00,00,00,00,00,00,00,00,00,00,00,53
51,00,00,00,00,00,00,00,00,00,00,00,00,00,00,00,00,00,53
43,00,00,00,00,00,00,00,00,00,00,00,00,00,00,00,00,00,42